6,7,90,
1111111
1000011
1100001
1100011
1100011
1111111