16,16,50
1111111111111111
1111111111100001
1000010010100001
1000010010100001
1000000010100001
1000000000000001
1000000020000001
1000000000000001
1000000000000001
1000000011000001
1000001111000001
1000001100000001
1000000000000001
1000000000000001
1000000000000001
1111111111111111